XXXXXXXXXXXXXXXX
X00X0000000X000X
X00X0000000X000X
X00000000000000X
X00X0000000X000X
X00X0000000X000X
X00000000000000X
X00X0000000X000X
X00X0000000X000X
XXXXXXXX0XXXXXXX
XXXXXXXX0XXXXXXX
XXXXXXXX1XXXXXXX
XXXXXXXXXXXXXXXX
XXXXXXXXXXXXXXXX