XXXXXXXXXXXXXXX
XXXXXXXXXXXXXXX
XX000000X1000XX
XX00000000000XX
XX00000X00000XX
XX0X000000000XX
XX00000000000XX
XX00000000000XX
XX000000000000X
XXXXXXXXXXXXXXX
XXXXXXXXXXXXXXX