               XXXXXX
               XX99XX
            XXXX0000XXXXXXX
            XX000000000000X
            XX000000000000X
            XXVVVVVVVVV000X
            XX0000HHHHHHH0X
            XX0000HHHHHHH0X
            XX0000HHHHHHH0X
            XX0000HHHHHHH0X
            XX0000HHHHHHH0X
            XX000000000000X
            XX0000XXXXXXXXX
            XX0000X
            XX0000X
            XX0000X
            XX0000XXXXXXXXX
            XX000000000000X
            XX000000000000X
            XX000000000000X
            XXVVVVVVV00VVVX
            XXXX0000000000X
            XXXX0000000000X
            XXXX000X000000X
            XXXX0000000000X
            XXXX0000000000X
            XXXX0000000000X
            XXXXXXX0000000X
                  X00000XXX
                  X00000X
                  X00000X
                  X0000XX
                  X00000X
                  X00000XXXXXXXXXXXXXXXXXXX
       XXXXXXXXXXXX00000XXXX00000000000000X
       X0000000000000000000000000000000000X
       X0XXXXXXXXXX00000000000000XXXXXX000X
       X0XXXXXXXXXXX0000000000000XXXXXX000X
       X0XXXXXXXXXX00000000000000XXXXXX000X
       X0XXXXXXXXXXX000XXXXXX0000XXX8XX000X
       X0XXXXXXXXXX00000XXXXX000X000800000X
       X0XXXXXXXXXXX000X77XXX0000000000000X
       X0XXXXXXXXXX00000000XXVVVVVVVVVVVVVX
       X0XXXXXXXXXXX0000000000000000000000X
XXXXXXXX0XXXXXXXXXX00000000000000000000000X
XXXXXX000XXXXXXXXXXX0000XXXXXXXXXXXXXXXXXXX
X00000000XXXXXXXXXX0X00XXXXXX0000000000000X
X00000000000000000000000XXXXX00000XXXX0000X
X0000000000000000000000XX6XXX00000XXXX0000X
XXXXXXX000000000000000000000000000X55X0000X
      X00000000000000000000000000000000000X
      X00000000000000000000000000000000000X
      X00000000000000000000000000000000000X
      XXXXX0000000000000XXXXX0000000000000X
      XXXXX0XX0000000000XXXXX0000000000000X
      X000000X0000000000XXXXX0000000000000X
      X000000XXXX0000000XX4XX0000000000000X
      X000000000X0000000000000000000000000X
      X000000000X0000000000000000000000000X
      X000000000X0000000000000000000000000X
      XVVVVXXXXXXVVV000VVVVVVVVVVVVVVVVVVVX
      X0000000000000X000000000000000000000X
      X00000000000000000000000000000000000X
      XXXXXXXX0000000000000000000000000000X
             X0000000000000000000000000000X
             XXXXXXXXX0000XXXXXXXXXXXXXXXXX
                     X0000X
                     X0000X
                     X0000X
                     X0000X
                     X0000X
             XXXXXXXXX0000XXXXXXXXX
             X00000000000000000000X
             X00000000000000000000X
             X000000XX000000000000X
             XVVVVVVXXVVVVVV000000X
             X000000XXHHHHHHHHHHHHX
             X000000XXHHHHHHHHHHHHX
             X000000XXHHHHHHHHHHHHX
             X000000XXHHHHHHHHHHHHX
             XVVVVVVXXHHHHHHHHHHHHX
             X000000XX000000000000X
             X00000000000000000000X
             X00000000000000HHHHHHX
             XXX000000000000HHHHHHX
             XXX000000XXXXXXHHHHHHX
             XXX000000XXXXXXHHHHHHX
             X00000000000000HHHHHHX
             X00000000000000000000X
             X00000000000000000000X
             XVV0VVVV00VVVVVVVVVVVX
             X00000000000000000000X
             X00000000000000000000X
             X00000000000000000000X
             XXXXXXXXXXXHHHHHH0000X
             XXXXXXXXXXXHHHHHH0000X
             XXXXXXXXXXXHHHHHHVVVVX
             X0000000000HHHHHH0000X
             X0000000000HHHHHH0000X
             X00000000000000000000X
             X00000000000000000000X
             XVVVV000XVVVVVVVVVVVVX
             X000000000000000HHHHHX
             X000000000000000HHHHHX
             X0000000000000HHHHH00X
             X0000000000HH0HHHHH00X
             XXXXXXXXXXXHHXXXXXXXXX
                       XHHX
                       XHHX
                       XHHX
                       X00X
             XXXXXXXXXXXOOXXXXXXXXX
             X00000000000000000000X
             X00000000000000000000X
             X000XXXXX0000XXXXX000X
             X000XXXXX0000X000X000X
             X000XXXXX0000X000X000X
             X00XX1XXX000XX2XXX000X
             X0000P000000000000000X
             X00000000000000000000X
             X00000000000XXXXXXX00X
             X000XXXXX000XXXXXXX00X
             X00000000000XX33XXX00X
             X00000000000000000000X
             X00000000000000000000X
             X00000000000000000000X
             X00000XXX000XXXXXX000X
             X00000XXX000000000000X
             X00000XXX000000000000X
             XXXXXXXXXXXXXXXXXXXXXX
