XXXXXXXXXX00XXXXXXXXXX
XXXXXXXXXX00XXXXXXXXXX
X00000000000000000000X
X00000000000000000000X
X000XXXXX0000XXXXX000X
X000XXXXX0000XXXXX000X
X000XXXXX0000XXXXX000X
X00XX1XXX000XX1XXX000X
X00000000000000000000X
X00000000000000000000X
X00000000000XXXXXXX00X
X000XXXXX000XXXXXXX00X
X00000000000XXXXXXX00X
X00000000000XXX1XXX00X
X00X00000000000000000X
X00000000000000000000X
X00000000000XXXXXX000X
X00000XXXX00000000000X
X00000XXXX00000000000X
X00000XXXX00000000000X
XXXXXXXXXXXXXXXXXXXXXX
