XXXXXXXXXXXXXXXXX
XXXXXXXXXXXXXXXXX
XX00000000000000X
XXXX000000000000X
XXXXXX0000OOO000X
XX00XX0000000000X
XX00000000000000X
XXXXXXX0000XXXXXX
XX00000000000000X
XX00000000000000X
XX00000000000000X
XXX000000000000XX
XXXXXXXX1XXXXXXXX
XXXXXXXXXXXXXXXXX
XXXXXXXXXXXXXXXXX
