XXX11XXXXXXXXX
XX0000XXXXXXXX
X000000000000X
X000000000000X
XVVVVVVVV0000X
X0000HHHHHHH0X
X0000HHHHHHH0X
X0000HHHHHHH0X
X0000HHHHHHH0X
X0000HHHHHHH0X
X000000000000X
X000000000000X
X0000XXXXXXXXX
X0000X
X0000X
X0000XXXXXXXXX
X000000000000X
X000000000000X
X000000000000X
XVVVVVVV00VVVX
X000000000000X
XXX0000000000X
XXX000X000000X
XXX0000000000X
XXX0000000000X
XXX0000000000X
XXX0000000000X
  XXXX0000000X
     X0000000X
     X00000XXX
     X00000X