      X0000X
      X0000X
XXXXXXX0000X
XHHHHHHH000X
XHHHHHHH000X
XHHHHHHH000X
XHHHHHHH000X
XHHHHHHH000X
XHHHHHHH000X
XHHHHHHH000X
X0000000000X
X0000000000X
X0000000000X
X0000000000X
XXX0000XXXCX
XXXX11XXXX0X