XXXXXXXXXXXXXXXX
X00000000000000X
X00000000000000X
X00000XXX000000X
X000000XX000000X
X00000000000000X
XX000000000000XX
XX000000000000XX
XXXXX1XXXXXX0XXX
XXXXXXXXXXXXXXXX
XXXXXXXXXXXXXXXX