XXXXXXXXXXXXXX
X0000000002XXX
X00000000000XX
X0000XX00000XX
X0000XX00000XX
X00000000000XX
XX000000000XXX
X00000000000XX
XXX1XXXXXXXXXX
XXXXXXXXXXXXXX