XXXXXXXXXXXXX
X000X000000XX
X000X0000000X
XXXXX000XX0XX
X0000000XX0XX
X0XX0000XX0XX
X00000000000X
XXXXX1XXXXXXX
XXXXXXXXXXXXX