XXXXXXXXXXXXX
X0000000000XX
X00000000000X
X0000XX00000X
X00000000000X
X00000000000X
XX000000000XX
XXXXX1XXXXXXX
XXXXXXXXXXXXX