XXXXXXXXXXXXXXXXX
X00000XXXXXXX0000X
X00000XXXXXXX0000X
X0000000000000000X
X0000000000000X00X
XX20000000000XX00X
X000000000000XX00X
X0000000000000000X
XXXXXXXXX1XXXXXXXX
XXXXXXXXXXXXXXXXXX
XXXXXXXXXXXXXXXXXX