XXXXXXXXXXXXXXXXX
X000XXX00XXX00X0X
XXXXXXXXXXXXXXX0X
X000000000000000X
X000000000000000X
XX10000000000000X
X000000000000000X
X000X000000000X0X
XXXXXXXXXXXXXXXXX
XXXXXXXXXXXXXXXXX
XXXXXXXXXXXXXXXXX