XXXXXXX1XXXXXXX
XX000X000X000XX
X0000000000000X
X0000000000XX0X
XXX0000000XXX0X
X0000000000000X
X0000000000XX0X
XXX00000000XX0X
X0000000000000X
X0000000000000X
XXXXXXX1XXXXXXX