        XXXXXXXXXXXXXXXXXXXXXXXXXXXXXXXXXXXXXXXXXX
        X0000000000000XXX000000000000000000000000X
        X0000000000000XXX000000000000000000000000X
        X0000000000000XXX000000000000000000000000X
        X0000000000000XXX00000XXXXXXXXXXXXXXX0000X
 X111XXXX0000000000000XXX00000XXXXXXXXXXXXXXX0000X
 X000XXXX0000000000000XXX00000XXXXXXXXXXXXXXX0000X
 X000XXXX00000XXX00000XXX00000XXXXXXXXXXXXXXX0000X
 X00XXXXXHHHHHXXXHHHHHXXXHHHHHXXXXXXXXXXXXXXX0000X
XHHHHHXXXHHHHHXXXHHHHHXXXHHHHHXXXXXXXXXXXXXXX0000X
XHHHHHXXXHHHHHXXXHHHHHXXXHHHHHXXXXXXXXXXXXXXX0000X
XHHHHHXXXHHHHHXXXHHHHHXXXHHHHHHHHHHH0000000000000X
XHHHHHXXXHHHHHXXXHHHHHXXXHHHHHHHHHHH0000000000000X
XHHHHHXXXHHHHHXXXHHHHHXXXHHHHHHHHHHH0000000000000X
XHHHHHXXXHHHHHXXXHHHHHXXXHHHHHHHHHHH0000000XXXXXXX
XHHHHHXXXHHHHHXXXHHHHHXXXHHHHHHHHHH00000000X
XHHHHHXXXHHHHHXXXHHHHHXXXHHHHHHXXXXXX000000X
XHHHHHXXXHHHHHXXXHHHHHXXXHHHHHHXXXXXX000000X
XHHHHHXXXHHHHHXXXHHHHHXXX000HHHXXXXXX000000X
XHHHHHXXXHHHHHXXX00000XXX000000XXXXXX000000X
XHHHHHXXXHHHHHXXX00000000000000XXXXXX000000XXXXXXX
XHHHHHXXXHHHHHXXXXX000000000000XXXXXX000000000000X
XHHHHHXXXHHHHHXXXXX000000000000XXXXXX0000X0000000X
XHHHHHXXXHHHHHHHXXXXXXXXXXXXXXXXXXXXX000000000000X
XHHHHH000HHHHHHHXXXXXXXXXXXXXXXXXXXXX000000000000X
X000000000000000XXXXXXXXXXXXXXXXXXXXXHHHH00000000X
X000000X00000000XXXXXXXXXXXXXXXXXXXXXHHHHHXXX0000X
X000000000000000XXXXXXXXXXXXXXXXXXXXXHHHHHXXX0000X
X000000000000000000000XXXXXXXXXXXXXXXHHHHHXXX0000X
X000000000000000000000XXXXXXXXXXXXXXXHHHHHXXX0000X
X000000000000000000000XXXXXXXXXXXXXXXHHHHHXXX0000X
XXXXXXXXXXXXXXXX000000XXXXXXXXXXXXXXXHHHHHXXX0000X
XXXXXXXXXXXXXXXX000000XXXXXXXXXXXXXXXHHHHHXXX0000X
XXXXXXXXXXXXXXXXXXXXXXXXXXXXXXXXXXXXXHHHHHXXX0000X
XHHHHHHHHHHHHHHHXXXXXXXXXXXXXXXXXXXXXHHHHHXXX0000X
XHHHHHHHHHHHHHHHXXXXXXXXXXXXXXXXXXXXXHHHHHXXX0000X
XHHHHHHHHHHHHHHHXXXXXXXXXXXXXXXXXXXXXHHHHHXXX0000X
XHHHHHHHHHHHHHHHXXXXXXXXXXXXXXXXXXXXXHHHHHXXX0000X
XHHHHHHHHHHHHHHHHHHHHHHHHHHHHHXXXXXXXHHHHHXXX0000X
XXXXXXXXXXHHHHHHHHHHHHHHHHX00HHXXXXXXHHHHHXXX0000X
XXXXXXXXXXHHHHHHHHHHHHHHHH000HHXXXXXXHHHH00000000X
        XX00HHHXXXXXXXXXHH000HHXXXXXXHHH000000000X
         X00HHHXXXXXXXXXHH000HHXXXXXXHHH000000000X
         X00HHHXXXXXXXXXHH000HHXXXXXXHHH000XXXXXXX
         X00HHHXXXXXXXXXHH000HHXXXXXXHHH000X
         X00HHHXXXXXXXXXHH000HHXXXXXXHHH000X
         X00HHHXXXXXXXXXHH000HHXXXXXXHHH000X
         X00HHHXXXXXXXXXHH000HHXXXXXXHHH000X
         X00HHHXXXXXXXXXHH000HHXXXXXXHHH000X
XXXXXXXXXX00HHHXXXXXXXXXHH000HHXXXXXXHHH000XXXXXXX
XHHHHHHHHH00HHHHHHHHHHHHHHXXXHHHHHHHHHHH000HHHHHHX
XHHHHHHHHH00HHHHHHHHHHHHHHXXXHHHHHHHHHHH000HHHHHHX
XHHHHHHHHH000HHHHHHHHHHHH0XXX0HHHHHHHHH000HHHHHHHX
XHHHHHHHHH0000HHHHHHHHHH0000000HHHHHHH0000HHHHHHHX
XHHHHHHHH0000000000000000000000000000X0000HHHHHHHX
XHHHHHHHH00000000000000000000X00000000000HHHHHHHHX
XHHHHHHHH0000000000000000000000000000000OHHHHHHHHX
XXXXXXXXXXXXXXXXXXXXXXXXX000000XXXXXXXXXXXXXXXXXXX
XXXXXXXXXXXXXXXXXXXXXXXXXX111XXXXXXXXXXXXXXXXXXXXX
