XXXXXXXXXXXXXX
X000000000000X
X000000000000X
X00000XX00000X
X00000XX00000X
X000000000000X
XX0000000000XX
XXXXX1XXXXXXXX
XXXXXXXXXXXXXX